pʰu	pu
tu	du
tʰu	tu
ku	gu
kʰu	ku
xu	hu
mu	mu
u	u
pu	bu
pi	bi
pʰi	pi
ti	di
tʰi	ti
tɕi	ji
ɕi	xi
tɕʰi	qi
mi	mi
ȵi	ni
li	li
i	i
tɕy	jyu
ɕy	xyu
tɕʰy	qyu
ȵy	nyu
y	yu
pei	bei
pʰei	pei
tei	dei
tʰei	tei
tsei	zei
sei	sei
tsʰei	cei
tʂei	zhei
ʂei	shei
tʂʰei	chei
xei	hei
mei	mei
nei	nei
ŋei	ngei
lei	lei
ɻei	rei
pɛ	bae
pʰɛ	pae
tɛ	dae
tʰɛ	tae
tsɛ	zae
sɛ	sae
tsʰɛ	cae
kɛ	gae
kʰɛ	kae
xɛ	hae
mɛ	mae
nɛ	nae
ŋɛ	ngae
lɛ	lae
pa	ba
pʰa	pa
tʰa	ta
tsa	za
sa	sa
tsʰa	ca
ka	ga
kʰa	ka
xa	ha
ma	ma
na	na
ŋa	nga
la	la
ta	da
pɔ	bo
pʰɔ	po
tɔ	do
tʰɔ	to
tsɔ	zo
sɔ	so
tsʰɔ	co
tʂɔ	zho
ʂɔ	sho
ɻɔ	ro
tʂʰɔ	cho
kɔ	go
kʰɔ	ko
xɔ	ho
mɔ	mo
ŋɔ	ngo
lɔ	lo
nɔ	no
nzɔ	nzo
tɤu	dou
tʰɤu	tou
tsɤu	zou
sɤu	sou
tsʰɤu	cou
tʂɤu	zhou
ʂɤu	shou
ɻɤu	rou
tʂʰɤu	chou
kɤu	gou
kʰɤu	kou
xɤu	hou
nɤu	nou
ŋɤu	ngou
lɤu	lou
tʂʅɘ	zhe
ʂʅɘ	she
tʂʰʅɘ	che
ɻʅɘ	re
tsɿ	zi
sɿ	si
tsʰɿ	ci
nzɿ	nzi
tʂʅ	zhi
ʂʅ	shi
tʂʰʅ	chi
tsʮ	zu
sʮ	su
zʮ	zsu
tsʰʮ	cu
nzʮ	nzu
tɕia	jia
ɕia	xia
tɕʰia	qia
ȵia	nia
lia	lia
pia	bia
ia	ia
piɔ	bio
pʰiɔ	pio
tiɔ	dio
tʰiɔ	tio
tɕiɔ	jio
ɕiɔ	xio
tɕʰiɔ	qio
miɔ	mio
ȵiɔ	nio
liɔ	lio
iɔ	io
tiɤu	diou
tɕiɤu	jiou
ɕiɤu	xiou
tɕʰiɤu	qiou
ȵiɤu	niou
liɤu	liou
iɤu	iou
tʰiɤu	tiou
ɳiɤu	nriou
tɕie̞	jie
ɕie̞	xie
tɕʰie̞	qie
kie̞	gie
kʰie̞	kie
ŋie̞	ngie
ie̞	ie
puo̞	buo
tuo̞	duo
tʰuo̞	tuo
tsuo̞	zuo
suo̞	suo
tsʰuo̞	cuo
kuo̞	guo
kʰuo̞	kuo
xuo̞	huo
muo̞	muo
luo̞	luo
uo̞	uo
tuei	duei
tsuei	zuei
suei	suei
tsʰuei	cuei
kuei	guei
kʰuei	kuei
xuei	huei
luei	luei
uei	uei
tʰuei	tuei
tuɛ	duae
tʰuɛ	tuae
suɛ	suae
tsʰuɛ	cuae
kuɛ	guae
kʰuɛ	kuae
xuɛ	huae
luɛ	luae
uɛ	uae
tsuɛ	zuae
tsua	zua
kua	gua
kʰua	kua
xua	hua
nzua	nzua
ua	ua
sua	sua
tɕyo̞	jyuo
ɕyo̞	xyuo
tɕʰyo̞	qyuo
ȵyo̞	nyuo
yo̞	yuo
tɕye̞	jyue
ɕye̞	xyue
pəŋ	beng
pʰəŋ	peng
təŋ	deng
tʰəŋ	teng
tsəŋ	zeng
səŋ	seng
tsʰəŋ	ceng
tʂəŋ	zheng
ʂəŋ	sheng
ɻəŋ	reng
tʂʰəŋ	cheng
kəŋ	geng
kʰəŋ	keng
xəŋ	heng
məŋ	meng
nəŋ	neng
nzəŋ	nzeng
ŋəŋ	ngeng
ləŋ	leng
piəŋ	bieng
pʰiəŋ	pieng
tiəŋ	dieng
tʰiəŋ	tieng
tɕiəŋ	jieng
ɕiəŋ	xieng
tɕʰiəŋ	qieng
miəŋ	mieng
ȵiəŋ	nieng
liəŋ	lieng
iəŋ	ieng
tuəŋ	dueng
tʰuəŋ	tueng
tsuəŋ	zueng
suəŋ	sueng
zuəŋ	zsueng
tsʰuəŋ	cueng
kuəŋ	gueng
kʰuəŋ	kueng
xuəŋ	hueng
luəŋ	lueng
uəŋ	ueng
tɕyəŋ	jyueng
ɕyəŋ	xyueng
tɕʰyəŋ	qyueng
yəŋ	yueng
pã	bang
pʰã	pang
tã	dang
tʰã	tang
tsã	zang
sã	sang
tsʰã	cang
tʂã	zhang
ʂã	shang
ɻã	rang
tʂʰã	chang
kã	gang
kʰã	kang
xã	hang
mã	mang
nã	nang
ɳã	nrang
nzã	nzang
ŋã	ngang
lã	lang
tɕiã	jiang
ɕiã	xiang
tɕʰiã	qiang
ȵiã	niang
liã	liang
iã	iang
piẽ̞	bie
pʰiẽ̞	pie
tiẽ̞	die
tʰiẽ̞	tie
tɕiẽ̞	jie
ɕiẽ̞	xie
tɕʰiẽ̞	qie
miẽ̞	mie
ȵiẽ̞	nie
liẽ̞	lie
iẽ̞	ie
tuõ̞	duon
tʰuõ̞	tuon
tsuõ̞	zuon
suõ̞	suon
tsʰuõ̞	cuon
kuõ̞	guon
kʰuõ̞	kuon
xuõ̞	huon
nzuõ̞	nzuon
luõ̞	luon
uõ̞	uon
zuõ̞	zsuon
nuõ̞	nuon
tɕyẽ̞	jyue
ɕyẽ̞	xyue
tɕʰyẽ̞	qyue
yẽ̞	yue
pʌʔ	baq
pʰʌʔ	paq
tʌʔ	daq
tʰʌʔ	taq
tsʌʔ	zaq
sʌʔ	saq
tsʰʌʔ	caq
tʂʌʔ	zhaq
ʂʌʔ	shaq
ɻʌʔ	raq
tʂʰʌʔ	chaq
kʌʔ	gaq
kʰʌʔ	kaq
xʌʔ	haq
mʌʔ	maq
ŋʌʔ	ngaq
ɳʌʔ	nraq
lʌʔ	laq
piʌʔ	biaq
pʰiʌʔ	piaq
tiʌʔ	diaq
tʰiʌʔ	tiaq
tɕiʌʔ	jiaq
ɕiʌʔ	xiaq
tɕʰiʌʔ	qiaq
iʌʔ	iaq
miʌʔ	miaq
ȵiʌʔ	niaq
liʌʔ	liaq
tuʌʔ	duaq
tʰuʌʔ	tuaq
tsuʌʔ	zuaq
suʌʔ	suaq
zuʌʔ	zsuaq
tsʰuʌʔ	cuaq
kuʌʔ	guaq
kʰuʌʔ	kuaq
xuʌʔ	huaq
uʌʔ	uaq
luʌʔ	luaq
tɕyʌʔ	jyuaq
ɕyʌʔ	xyuaq
tɕʰyʌʔ	qyuaq
yʌʔ	yuaq
ər	er
